##########......###
#########G.GG######
#######...#..######
#######......G..###
####..G.........###
##.G.....G......###
##......#.........#
##................#
#G..G.#####....E.G#
###################
